border_size=1
usage=map

Mm^Xm, Mm^Xm, Mm^Xm, Mm^Xm, Mm^Xm, Mm^Xm, Mm^Xm, Mm^Xm, Mm^Xm, Mm^Xm, Mm^Xm
Mm^Xm, Gg   , Gg   , Gg   , Gg   , Gg^Vh, Gg   , Gg   , Gg   , Gg   , Mm^Xm
Mm^Xm, Gg   , Gg   , Gg   , Gs^Fp, Gg   , Gs^Fp, Gg   , Gg   , Gg   , Mm^Xm
Mm^Xm, Ce   , Gg   , Gg   , Gg   , Gg   , Gg   , Gg   , Gg   , Ce   , Mm^Xm
Mm^Xm, 1 Ke , Gg   , Gg   , Gg   , Gs^Fp, Gg   , Gg   , Gg   , 2 Ke , Mm^Xm
Mm^Xm, Ce   , Gg   , Gg   , Gg   , Gg   , Gg   , Gg   , Gg   , Ce   , Mm^Xm
Mm^Xm, Gg   , Gg   , Gg   , Hh   , Gg   , Hh   , Gg   , Gg   , Gg   , Mm^Xm
Mm^Xm, Gg   , Gg   , Gg   , Gg   , Gg^Vh, Gg   , Gg   , Gg   , Gg   , Mm^Xm
Mm^Xm, Mm^Xm, Mm^Xm, Mm^Xm, Mm^Xm, Mm^Xm, Mm^Xm, Mm^Xm, Mm^Xm, Mm^Xm, Mm^Xm
