border_size=1
usage=map

Mm^Xm, Mm^Xm, Mm^Xm, Mm^Xm, Mm^Xm, Mm^Xm, Mm^Xm, Mm^Xm, Mm^Xm, Mm^Xm, Mm^Xm, Mm^Xm, Mm^Xm, Mm^Xm, Mm^Xm
Mm^Xm, Gg   , Gg   , Gg   , Gg   , Gg   , Gg   , Mm^Xm, Gg   , Gg   , Gg   , Gg   , Gg   , Gg   , Mm^Xm
Mm^Xm, Gg   , Gg   , Gg   , Gg   , Gg   , Gg^Vh, Mm^Xm, Gg^Vh, Gg   , Gg   , Gg   , Gg   , Gg   , Mm^Xm
Mm^Xm, Gg   , Ce   , Gg   , Gg   , Gg   , Gg   , Mm^Xm, Gg   , Gg   , Gg   , Gg   , Ce   , Gg   , Mm^Xm
Mm^Xm, Gg   , 1 Ke , Gg   , Gg   , Gg   , Gg   , Gg   , Gg   , Gg   , Gg   , Gg   , 2 Ke , Gg   , Mm^Xm
Mm^Xm, Gg   , Ce   , Gg   , Gg   , Gg   , Gg   , Mm^Xm, Gg   , Gg   , Gg   , Gg   , Ce   , Gg   , Mm^Xm
Mm^Xm, Gg   , Gg   , Gg   , Gg   , Gg   , Gg^Vh, Mm^Xm, Gg^Vh, Gg   , Gg   , Gg   , Gg   , Gg   , Mm^Xm
Mm^Xm, Gg   , Gg   , Gg   , Gg   , Gg   , Gg   , Mm^Xm, Gg   , Gg   , Gg   , Gg   , Gg   , Gg   , Mm^Xm
Mm^Xm, Mm^Xm, Mm^Xm, Mm^Xm, Mm^Xm, Mm^Xm, Mm^Xm, Mm^Xm, Mm^Xm, Mm^Xm, Mm^Xm, Mm^Xm, Mm^Xm, Mm^Xm, Mm^Xm
