border_size=1
usage=map

Mm^Xm, Mm^Xm, Mm^Xm, Mm^Xm, Mm^Xm, Mm^Xm, Mm^Xm, Mm^Xm, Mm^Xm, Mm^Xm, Mm^Xm, Mm^Xm, Mm^Xm
Mm^Xm, 1 Ke , Ce   , Gg   , Gg   , Gg   , Gg   , Gg   , Gg   , Gg   , Gg   , Gg   , Mm^Xm
Mm^Xm, Ce   , Gg   , Gg   , Gg   , Gg   , Gg^Vh, Gg   , Gg^Vh, Gg   , Gg   , Gg   , Mm^Xm
Mm^Xm, Gg   , Gg   , Gg^Vh, Gs^Fp, Gg   , Gg   , Gg   , Gg   , Gg   , Gg   , Gg   , Mm^Xm
Mm^Xm, Gg   , Gg^Vh, Gg   , Gg   , Gg   , Gg   , Hh   , Gg   , Gg   , Gg   , Gg   , Mm^Xm
Mm^Xm, Gg   , Gg   , Gg   , Gg   , Hh   , Gg   , Gg   , Gg   , Gg   , Gg^Vh, Gg   , Mm^Xm
Mm^Xm, Gg   , Gg   , Gg   , Gg   , Gg   , Gg   , Gg   , Gs^Fp, Gg^Vh, Gg   , Gg   , Mm^Xm
Mm^Xm, Gg   , Gg   , Gg   , Gg^Vh, Gg   , Gg^Vh, Gg   , Gg   , Gg   , Gg   , Ce   , Mm^Xm
Mm^Xm, Gg   , Gg   , Gg   , Gg   , Gg   , Gg   , Gg   , Gg   , Gg   , Ce   , 2 Ke , Mm^Xm
Mm^Xm, Mm^Xm, Mm^Xm, Mm^Xm, Mm^Xm, Mm^Xm, Mm^Xm, Mm^Xm, Mm^Xm, Mm^Xm, Mm^Xm, Mm^Xm, Mm^Xm
