border_size=1
usage=map

Wot         , Wot         , Wot         , Wot         , Wot         , Wot         , Wot         , Wot         
Wot         , Wot         , Md^Xm       , Md^Xm       , Md^Xm       , Wot         , Wot         , Wot         
Wot         , Wot         , Md^Xm       , Dd^Do       , Gs          , Md^Xm       , Md^Xm       , Wot         
Wot         , Md^Xm       , Ce          , Gs          , Wwf         , Ce          , 1 Ke        , Wot         
Wot         , 2 Ke        , Ce          , Wwf         , Gs          , Ce          , Gs^Vh       , Wot         
Wot         , Gs^Vh       , Md^Xm       , Gs          , Dd^Do       , Md^Xm       , Md^Xm       , Wwt         
Wot         , Md^Xm       , Wot         , Md^Xm       , Md^Xm       , Md^Xm       , Wot         , Wot         
Wot         , Wot         , Wot         , Wot         , Wot         , Wot         , Wot         , Wot         
