border_size=1
usage=map

Ms^Xm       , Ms^Xm       , Ms^Xm       , Ms^Xm       , Ms^Xm       , Ms^Xm       , Ms^Xm       , Ms^Xm       
Ms^Xm       , Ms^Xm       , Ms^Xm       , Ms^Xm       , Aa          , Ms^Xm       , Ms^Xm       , Ms^Xm       
Ms^Xm       , Ms^Xm       , Cea         , Aa          , Wwf         , Cea         , 1 Kea       , Ms^Xm       
Ms^Xm       , 2 Kea       , Cea         , Wwf         , Ds          , Cea         , Aa^Vha      , Ms^Xm       
Ms^Xm       , Aa^Vha      , Ms^Xm       , Ds          , Ms^Xm       , Ms^Xm       , Ms^Xm       , Ms^Xm       
Ms^Xm       , Ms^Xm       , Ms^Xm       , Ms^Xm       , Ms^Xm       , Ms^Xm       , Ms^Xm       , Ms^Xm       
