border_size=1
usage=map

Wot         , Wot         , Wot         , Wot         , Mm^Xm       , Wot         , Wot         , Wot         , Wot         , Wot         
Wot         , Wot         , Wot         , Mm^Xm       , Gs^Vh       , Mm^Xm       , Mm^Xm       , Wot         , Wot         , Wot         
Wot         , Wot         , Mm^Xm       , Mm^Xm       , Ce          , 2 Ke        , Dd^Do       , Mm^Xm       , Mm^Xm       , Wot         
Wot         , Wot         , Mm^Xm       , Dd          , Gg          , Ce          , Ce          , 3 Ke        , Gs^Vh       , Mm^Xm       
Wot         , Mm^Xm       , Dd          , Wwf         , Wwf         , Gg          , Gg          , Ce          , Mm^Xm       , Mm^Xm       
Mm^Xm       , Mm^Xm       , Cv          , Gg          , Gg          , Wwf         , Wwf         , Dd          , Mm^Xm       , Wot         
Mm^Xm       , Gg^Ve       , 1 Kv        , Cv          , Cv          , Gg          , Dd          , Mm^Xm       , Wot         , Wot         
Wot         , Mm^Xm       , Mm^Xm       , Dd^Do       , 4 Kv        , Cv          , Mm^Xm       , Mm^Xm       , Wot         , Wot         
Wot         , Wot         , Wot         , Mm^Xm       , Mm^Xm       , Gg^Ve       , Mm^Xm       , Wot         , Wot         , Wot         
Wot         , Wot         , Wot         , Wot         , Wot         , Mm^Xm       , Wot         , Wot         , Wot         , Wot         
