Wwf, Wwf, Gg, Md^Xm, Md^Xm, Md^Xm, Md^Xm, Gg, Wwf, Md^Xm, Md^Xm, Md^Xm, Wwf, Gg, Md^Xm, Mm, Md^Xm, Md^Xm, Gg, Wwf, Wwf
Gg, Wwf, Gs^Vh, Gg, Hh, Gg^Efm, Hh, Gg^Tf, Wwf, Wwf, Ce, Wwf, Wwf, Gg^Tf, Hh, Gg, Hh, Gg, Gs^Vh, Wwf, Gg
Gg, Gg, Wwf, Wwf, Gg, Gg, Gg, Gg, Gg, Gg, Wwf, Gg, Gg, Gg^Efm, Gg, Gg, Gg, Wwf, Wwf, Gg, Gg
Md^Xm, Gg, Gg, Gg, Wwf, Wwf, Gg, Ce, Gg, Gg, Wwf, Gg, Gg, Ce, Gg, Wwf, Wwf, Gg, Gg, Gg, Md^Xm
Gg, Gg, Gg, Gg, Gg, Wwf, Gg, Gs^Fp, Gs^Fp, Wwf, Wwf, Wwf, Gs^Fp, Gs^Fp, Gg, Wwf, Gg, Gg, Gg, Gg, Gg
Gg, Re, Hh, Gg, Ss^Vhs, Gg, Wwf, Wwf, Wwf, Wwf, Hh, Wwf, Wwf, Wwf, Wwf, Gg^Efm, Ss^Vhs, Gg, Hh, Re, Gg
Re, Gs^Fp, Hh^Fp, Gs, Gs, Gg, Gg, Hh, Mm, Ce, Wwf, Ce, Mm, Hh, Gg, Gg, Gs, Gs, Hh^Fp, Gs^Fp, Re
Md^Xm, Gg, Gs, Re^Tf, Gg, Gg, Gg, Gg^Efm, Hh^Tf, Wwf, Wwf, Wwf, Hh^Tf, Gg, Gg, Gg, Gg, Re^Tf, Gs, Gg, Md^Xm
Md^Xm, Gg, Hh, Mm, Re, Gg^Ve, Gg, Wwf, Wwf, Gs^Fp, Ww, Gs^Fp, Wwf, Wwf, Gg, Gg^Ve, Re, Mm, Hh, Gg, Md^Xm
Gg, Gg, Hh, Gs^Fp, Gg, Wwf, Wwf, Gg, Gg, Gs, Wwf, Gs, Gs, Gg, Wwf, Wwf, Gg, Gs^Fp, Hh, Gg, Gg
Gg, Gs^Fp, Gg, Gg, Gg, Wwf, Gg, Gg, Gg, Gs, Wwf, Gs, Gg, Gg, Gg, Wwf, Gg, Gg, Gs, Gs^Fp, Gs
Md^Xm, Chw, 1 Khw, Chw, Chw, Gg, Gg, Mm, Gs, Hh, Wwf, Hh, Gs, Mm, Gg, Gg, Chw, Chw, 2 Khw, Chw, Md^Xm
Ce, Md^Xm, Re, Gg, Gg, Md^Xm, Md^Xm, Mm^Xm, Mm^Xm, Wwf, Wwf, Wwf, Mm^Xm, Mm^Xm, Md^Xm, Md^Xm, Gg, Gg, Re, Md^Xm, Ce
