Md^Xm, Md^Xm, Md^Xm, Gg, Wwf, Md^Xm, Md^Xm, Md^Xm, Wwf, Gg, Md^Xm, Mm, Md^Xm
Md^Xm, Gg^Efm, Hh, Tb, Wwf, Wwf, Ce, Wwf, Wwf, Tb, Hh, Gg, Md^Xm
Gg, Gg, Gg, Gg, Gg, Gg, Wwf, Gg, Gg, Gg^Efm, Gg, Gg, Gg
Wwf, Wwf, Gg, Ce, Gg, Gg, Ww^Vm, Gg, Gg, Ce, Gg, Wwf, Wwf
Gg, Chw, Gg, Gs^Fp, Gs^Fp, Wwf, Wwf, Wwf, Gs^Fp, Gs^Fp, Gg, Chw, Gg
Md^Xm, 1 Khw, Wwf, Wwf, Wwf, Wwf, Hh, Wwf, Wwf, Wwf, Wwf, 2 Khw, Md^Xm
Gs, Chw, Gg, Hh, Mm, Ce, Wwf, Ce, Mm, Hh, Gg, Chw, Gs
Gg, Gg, Gg, Gg^Efm, Tb, Wwf, Wwf, Wwf, Tb, Gg, Gg, Gg, Gg
Re, Gg^Ve, Gg, Wwf, Wwf, Gs^Fp, Ww, Gs^Fp, Wwf, Wwf, Gg, Gg^Ve, Re
Gg, Wwf, Wwf, Gg, Gg, Gs, Wwf, Gs, Gs, Gg, Wwf, Wwf, Gg
Gg, Wwf, Gg, Gg, Gg, Gs, Ww^Vm, Gs, Gg, Gg, Gg, Wwf, Gg
Md^Xm, Gg, Gg, Mm, Gs, Hh, Wwf, Hh, Gs, Mm, Gg, Gg, Md^Xm
Gg, Md^Xm, Md^Xm, Mm^Xm, Mm^Xm, Wwf, Wwf, Wwf, Mm^Xm, Mm^Xm, Md^Xm, Md^Xm, Gg
