Md^Xm, Md^Xm, Md^Xm, Gg, Wwf, Md^Xm, Md^Xm, Md^Xm, Wwf, Gg, Md^Xm, Mm, Md^Xm
Md^Xm, Chw, Hh, Tb, Wwf, Wwf, Ce, Wwf, Wwf, Tb, Hh, Chw, Md^Xm
Gg, 4 Khw, Gg, Gg, Gg, Gg, Wwf, Gg, Gg, Gg^Efm, Gg, 2 Khw, Gg
Wwf, Chw, Gg, Ce, Gg, Gg, Ww^Vm, Gg, Gg, Ce, Gg, Chw, Wwf
Gg, Wwf, Gg, Gs^Fp, Gs^Fp, Wwf, Wwf, Wwf, Gs^Fp, Gs^Fp, Gg, Wwf, Gg
Md^Xm, Gg^Ve, Wwf, Wwf, Wwf, Wwf, Hh, Wwf, Wwf, Wwf, Wwf, Gg^Ve, Md^Xm
Gs, Gg, Gg, Hh, Mm, Ce, Wwf, Ce, Mm, Hh, Gg, Gg, Gs
Gg, Gg, Gg, Gg^Efm, Tb, Wwf, Ww^Vm, Wwf, Tb, Gg, Gg, Gg, Gg
Re, Gg^Ve, Gg, Wwf, Wwf, Gs^Fp, Ww, Gs^Fp, Wwf, Wwf, Gg, Gg^Ve, Re
Gg, Wwf, Wwf, Gg, Gg, Gs, Wwf, Gs, Gs, Gg, Wwf, Wwf, Gg
Gg, Chw, Gg, Gg, Gg, Gs, Ww^Vm, Gs, Gg, Gg, Gg, Chw, Gg
Md^Xm, 1 Khw, Chw, Mm, Gs, Hh, Wwf, Hh, Gs, Mm, Chw, 3 Khw, Md^Xm
Gg, Md^Xm, Md^Xm, Mm^Xm, Mm^Xm, Wwf, Wwf, Wwf, Mm^Xm, Mm^Xm, Md^Xm, Md^Xm, Gg
