border_size=1
usage=map

Xv          , Xv          , Xv          , Xv          , Xv          , Xv          , Xv          
Xv          , Xv          , Gd^Vhr      , Xv          , Gs^Vh       , Xv          , Xv          
Xv          , 2 Ke        , Ce          , Gs          , Ce          , 3 Ke        , Xv          
Xv          , Ce          , Wwf         , Gs          , Wwf         , Ce          , Xv          
Xv          , Ds          , Wwf         , Dd^Vda      , Wwf         , Ds          , Xv          
Xv          , Ce          , Ce          , Gs          , Ce          , Ce          , Xv          
Xv          , 1 Ke        , Gs^Vh       , Gs          , Gd^Vhr      , 4 Ke        , Xv          
Xv          , Xv          , Xv          , Xv          , Xv          , Xv          , Xv          
Xv          , Xv          , Xv          , Xv          , Xv          , Xv          , Xv          
