Gg, Gg, Gg, Gg, Gg, Gg, Gg, Gg, Gg, Gg, Gg, Gg, Gg, Gg
Gg, 3 Kh, Ch, Ch, Gs^Vh, Gg, Gs^Fds, Gg, Gg, Gs^Vh, Ch, Gg, 2 Kh, Gg
Gg, Ch, Wwf, Gg, Hh, Hh, Gs^Fds, Hh, Gg, Gg, Hh, Ch, Ch, Gg
Gg, Gs^Fds, Wwf, Gg, Hh^Fds, Gg, Wwrg, Gg, Gs^Vh, Gg, Gg, Wwf, Gg, Gg
Gg, Gg, Wwf, Gs^Vh, Wwf, Wwf, Hh, Wwg, Wwf, Hh^Fds, Wwf, Wwf, Hh, Gg
Gg, Ss, Hh, Wwg, Mm, Hh^Fds, Tb, Gg, Gs^Fds, Wwf, Wwg, Gs^Fds, Dd^Do, Gg
Gg, Dd^Do, Gs^Fds, Wwg, Wwf, Gs^Fds, Gg, Tb, Hh^Fds, Mm, Wwg, Hh, Ss, Gg
Gg, Hh, Wwf, Wwf, Hh^Fds, Wwf, Wwg, Hh, Wwf, Wwf, Gs^Vh, Wwf, Gg, Gg
Gg, Gg, Wwf, Gg, Gg, Gs^Vh, Gg, Wwrg, Gg, Hh^Fds, Gg, Wwf, Gs^Fds, Gg
Gg, Ch, Ch, Hh, Gg, Gg, Hh, Gs^Fds, Hh, Hh, Gg, Wwf, Ch, Gg
Gg, 1 Kh, Gg, Ch, Gs^Vh, Gg, Gg, Gs^Fds, Gg, Gs^Vh, Ch, Ch, 4 Kh, Gg
Gg, Gg, Gg, Gg, Gg, Gg, Gg, Gg, Gg, Gg, Gg, Gg, Gg, Gg
